?1 6 8 2
   #####
####x.x#
#....oo#
#..P...#
########